@@@@@@@@@@@@@@@@@@@@@@@@@@@@@@@@@@@@@@@@@@@@@@@@@@@@@@@@@@@@@@@@@@@@@@@@@@@@@@@@@@@@@@@@@@@@@@@@@@@@@@@@@@@@@@@@@@@@@@@@@@@@@@@@@@@@@@@@@@@@@@@@@@@@@@@@@@@@@@@@@@@@@@@@@@@@@@@@@@@@@@@@@@@@@@@@@@@@@@@@@@@@@@@@@@@@@@@@@@@@@@@@@@@@@@@@@@@@@@@@@@@@@@@@@@@@@@@
@@@F@@@@@@@@@@@@@@@@@@@@@@@@@@@@@@@@@@@@@@@@@@@@@@@@@@@@@@@@@@@@@@@@@@@@@@@@@@@@@@@@@@@@@@@@@@@@@@@@@@@@@@@@@@@@@@@@@@@@@@@@@@@@@@@@@@@@@@@@@@@@@@@@@@@@@@@@@@@@@@@@@@@@@@@@@@@@@@@@@@@@@@@@@@@@@@@@@@@@@@@@@@@@@@@@@@@@@@@@@@@@@@@@@@@@@@@@@@@@@@@@@@@@@@@@@@@ 
@@   @                               @       @                       @                       @                       @                       @               @               @               @                               @               @               @@
@@   @   @@@@@@@@@@@@@@@@@@@@@@@@@   @   @   @   @@@@@@@@@@@@@@@@@   @   @@@@@@@@@@@@@@@@@   @   @@@@@@@@@@@@@@@@@   @   @@@@@@@@@@@@@@@@@   @   @@@@@@@@@   @   @@@@@@@@@   @   @@@@@@@@@   @   @@@@@@@@@@@@@@@@@@@@@@@@@   @   @@@@@@@@@   @   @@@@@@@@@   @@
@@   @           @       @       @   @   @   @                   @   @           @       @   @                   @   @   @               @   @   @           @   @       @   @   @       @   @   @       @               @   @           @   @   @       @   @@
@@   @@@@@@@@@   @   @   @   @   @   @   @   @@@@@@@@@@@@@@@@@   @   @@@@@@@@@   @   @   @   @@@@@@@@@@@@@@@@@   @   @   @   @@@@@@@@@   @   @   @   @@@@@@@@@   @   @   @   @   @   @   @   @   @   @   @   @@@@@@@@@   @   @@@@@@@@@   @   @   @   @   @   @@
@@               @   @   @   @   @       @   @                   @               @   @   @                       @       @   @       @   @   @   @               @   @   @       @   @   @   @   @   @   @           @   @               @       @   @   @   @@
@@@@@@@@@@@@@@@@@@   @   @   @   @@@@@@@@@   @   @@@@@@@@@@@@@@@@@@@@@@@@@@@@@@@@@   @   @@@@@@@@@@@@@@@@@@@@@@@@@@@@@@@@@   @   @   @   @   @   @@@@@@@@@@@@@@@@@   @   @@@@@@@@@   @   @   @   @   @   @@@@@@@@@   @   @@@@@@@@@@@@@@@@@@@@@@@@@   @   @   @@
@@                   @       @           @   @   @                                   @                                   @   @   @   @   @   @                   @   @               @       @   @   @           @   @                               @   @   @@
@@   @@@@@@@@@@@@@@@@@@@@@@@@@@@@@@@@@   @   @   @   @@@@@@@@@@@@@@@@@@@@@@@@@@@@@@@@@@@@@@@@@@@@@@@@@@@@@@@@@@@@@@@@@   @   @   @   @   @   @@@@@@@@@@@@@@@@@   @   @@@@@@@@@@@@@@@@@@@@@@@@@   @   @@@@@@@@@   @   @@@@@@@@@@@@@@@@@@@@@@@@@@@@@@@@@   @   @@
@@                                   @   @       @   @               @                                       @       @   @   @   @       @   @       @           @   @                           @   @       @   @                   @               @   @   @@
@@@@@@@@@@@@@@@@@@@@@@@@@@@@@@@@@@   @   @@@@@@@@@   @   @@@@@@@@@   @   @@@@@@@@@@@@@@@@@@@@@@@@@@@@@@@@@   @   @   @   @   @   @@@@@@@@@   @   @   @   @@@@@@@@@   @   @@@@@@@@@@@@@@@@@@@@@@@@@   @   @   @   @@@@@@@@@@@@@@@@@   @   @@@@@@@@@   @   @   @@
@@                               @   @               @   @       @   @   @                               @   @   @   @   @   @           @   @   @   @   @           @   @                       @   @   @   @   @               @   @   @           @   @   @@
@@   @@@@@@@@@@@@@@@@@@@@@@@@@   @   @@@@@@@@@@@@@@@@@   @   @   @   @   @   @@@@@@@@@@@@@@@@@@@@@@@@@   @   @   @   @   @   @@@@@@@@@   @   @   @   @   @   @@@@@@@@@   @   @@@@@@@@@@@@@@@@@   @   @   @   @   @   @@@@@@@@@   @   @   @   @@@@@@@@@   @   @@
@@           @               @   @           @           @   @   @   @   @           @       @           @   @   @       @   @           @   @   @       @               @   @                   @   @   @       @   @           @   @   @   @           @   @@
@@@@@@@@@@   @   @@@@@@@@@   @   @@@@@@@@@   @   @@@@@@@@@   @   @   @   @@@@@@@@@   @   @   @   @@@@@@@@@   @   @@@@@@@@@   @   @@@@@@@@@   @   @@@@@@@@@@@@@@@@@@@@@@@@@   @   @@@@@@@@@@@@@@@@@   @   @@@@@@@@@   @   @@@@@@@@@   @   @   @   @@@@@@@@@   @@
@@           @   @       @   @           @   @               @   @   @   @       @   @   @   @   @           @           @   @               @                               @                       @               @   @           @   @   @   @       @   @@
@@   @@@@@@@@@   @   @   @   @@@@@@@@@   @   @@@@@@@@@@@@@@@@@   @   @   @   @   @   @   @   @   @   @@@@@@@@@@@@@@@@@   @   @@@@@@@@@@@@@@@@@@@@@@@@@@@@@@@@@@@@@@@@@@@@@@@@@@@@@@@@@@@@@@@@@@@@@@@@@@@@@@@@@@@@@@@@@   @   @@@@@@@@@   @   @   @   @   @   @@
@@               @   @   @   @           @   @                   @   @   @   @   @   @   @       @   @               @   @                                                                                   @           @   @           @   @   @   @   @   @@
@@@@@@@@@@@@@@@@@@   @   @   @   @@@@@@@@@   @   @@@@@@@@@@@@@@@@@   @   @   @   @   @   @@@@@@@@@   @   @@@@@@@@@   @   @@@@@@@@@@@@@@@@@@@@@@@@@@@@@@@@@@@@@@@@@@@@@@@@@@@@@@@@@@@@@@@@@@@@@@@@@@@@@@@@@   @   @@@@@@@@@   @   @@@@@@@@@   @   @   @   @   @@
@@                   @   @   @               @   @               @   @       @   @   @   @           @           @   @                                   @                                               @   @   @           @   @           @   @   @   @   @@
@@   @@@@@@@@@@@@@@@@@   @   @@@@@@@@@@@@@@@@@   @   @@@@@@@@@   @   @@@@@@@@@   @   @   @   @@@@@@@@@@@@@@@@@   @   @@@@@@@@@@@@@@@@@@@@@@@@@@@@@@@@@   @   @@@@@@@@@@@@@@@@@@@@@@@@@@@@@@@@@@@@@@@@@   @   @   @   @@@@@@@@@   @   @@@@@@@@@   @   @   @   @@
@@   @               @   @                       @   @       @   @               @   @   @                       @   @               @                   @   @                               @       @   @   @   @   @       @   @           @   @   @   @   @@
@@   @   @@@@@@@@@   @   @@@@@@@@@@@@@@@@@@@@@@@@@   @   @   @   @@@@@@@@@@@@@@@@@   @   @@@@@@@@@@@@@@@@@@@@@@@@@   @   @@@@@@@@@   @   @@@@@@@@@@@@@@@@@   @   @@@@@@@@@@@@@@@@@@@@@@@@@   @   @   @   @   @   @   @   @   @   @@@@@@@@@   @   @   @   @   @@
@@   @   @           @                           @   @   @   @           @           @                           @   @           @   @   @                   @   @               @       @   @   @   @   @   @   @   @   @   @           @   @   @   @   @   @@
@@   @   @   @@@@@@@@@@@@@@@@@@@@@@@@@@@@@@@@@   @   @   @   @@@@@@@@@   @   @@@@@@@@@@@@@@@@@@@@@@@@@@@@@@@@@   @   @@@@@@@@@   @   @   @   @@@@@@@@@@@@@@@@@   @   @@@@@@@@@   @   @   @   @   @   @   @   @   @   @   @   @@@@@@@@@   @   @   @   @   @   @@
@@   @   @           @       @               @   @   @   @           @   @   @               @               @   @           @   @       @   @               @   @           @   @   @   @   @   @   @   @   @   @   @   @               @       @   @   @   @@
@@   @   @@@@@@@@@   @   @   @   @@@@@@@@@   @   @   @   @@@@@@@@@   @   @   @   @@@@@@@@@   @   @@@@@@@@@   @   @@@@@@@@@   @   @@@@@@@@@   @   @@@@@@@@@   @   @@@@@@@@@   @   @   @   @   @   @   @   @   @   @   @   @@@@@@@@@@@@@@@@@@@@@@@@@   @   @   @@
@@   @           @   @   @   @   @       @   @   @   @           @   @       @   @       @   @   @       @   @           @   @               @   @       @   @           @   @   @   @   @   @   @   @   @   @   @   @                               @   @   @@
@@   @@@@@@@@@   @   @   @   @   @   @   @   @   @   @@@@@@@@@   @   @@@@@@@@@   @   @   @   @   @   @   @   @@@@@@@@@   @   @@@@@@@@@@@@@@@@@   @   @   @   @@@@@@@@@   @   @   @   @   @   @   @   @   @   @   @   @@@@@@@@@@@@@@@@@@@@@@@@@@@@@@@@@   @   @@
@@               @       @   @   @   @   @   @   @   @       @   @           @   @   @   @       @   @   @   @           @                       @   @   @               @   @   @   @   @   @   @       @   @   @           @                       @   @   @@
@@@@@@@@@@@@@@@@@@@@@@@@@@   @   @   @   @   @   @   @   @   @   @@@@@@@@@   @   @   @   @@@@@@@@@   @   @   @   @@@@@@@@@@@@@@@@@@@@@@@@@@@@@@@@@   @   @@@@@@@@@@@@@@@@@   @   @   @   @   @   @@@@@@@@@   @   @@@@@@@@@   @   @@@@@@@@@@@@@@@@@   @   @   @@
@@                           @   @   @   @   @   @   @   @   @           @   @   @   @               @   @   @                                       @                   @   @       @   @   @               @           @   @   @               @   @   @   @@
@@   @@@@@@@@@@@@@@@@@@@@@@@@@   @   @   @   @   @   @   @   @@@@@@@@@   @   @   @   @@@@@@@@@@@@@@@@@   @   @@@@@@@@@@@@@@@@@@@@@@@@@@@@@@@@@@@@@@@@@@@@@@@@@@@@@@@@@   @   @@@@@@@@@   @   @@@@@@@@@@@@@@@@@@@@@@@@@   @   @   @   @@@@@@@@@   @   @   @   @@
@@           @                   @   @   @   @   @       @           @   @       @   @               @   @                                                   @           @   @           @   @                           @   @   @   @       @   @   @   @   @@
@@@@@@@@@@   @   @@@@@@@@@@@@@@@@@   @   @   @   @@@@@@@@@@@@@@@@@   @   @@@@@@@@@   @   @@@@@@@@@   @   @@@@@@@@@@@@@@@@@@@@@@@@@@@@@@@@@@@@@@@@@@@@@@@@@   @   @@@@@@@@@   @   @@@@@@@@@   @   @@@@@@@@@@@@@@@@@@@@@@@@@   @   @   @   @   @   @   @   @   @@
@@           @   @                   @   @   @                   @   @               @           @   @                                                   @   @   @           @   @           @   @       @                   @   @   @   @   @   @   @       @@
@@   @@@@@@@@@   @   @@@@@@@@@@@@@@@@@   @   @@@@@@@@@@@@@@@@@   @   @@@@@@@@@@@@@@@@@@@@@@@@@   @   @@@@@@@@@@@@@@@@@@@@@@@@@@@@@@@@@@@@@@@@@@@@@@@@@   @   @   @   @@@@@@@@@   @   @@@@@@@@@   @   @   @   @@@@@@@@@@@@@@@@@   @   @   @   @   @   @@@@@@@@@@
@@   @           @   @       @           @           @           @                   @           @   @               @                       @           @   @   @   @       @   @           @   @   @   @                       @   @   @   @   @           @@
@@   @   @@@@@@@@@   @   @   @   @@@@@@@@@@@@@@@@@   @   @@@@@@@@@@@@@@@@@@@@@@@@@   @   @@@@@@@@@   @   @@@@@@@@@   @   @@@@@@@@@@@@@@@@@   @   @@@@@@@@@   @   @   @   @   @   @@@@@@@@@   @   @   @   @@@@@@@@@@@@@@@@@@@@@@@@@   @   @   @   @@@@@@@@@   @@
@@   @               @   @   @   @               @   @                               @   @       @   @   @       @   @           @       @   @   @           @   @   @   @   @           @   @   @   @                               @   @   @           @   @@
@@   @@@@@@@@@@@@@@@@@   @   @   @   @@@@@@@@@   @   @@@@@@@@@@@@@@@@@@@@@@@@@@@@@@@@@   @   @   @   @   @   @   @   @@@@@@@@@   @   @   @   @   @   @@@@@@@@@   @   @   @   @@@@@@@@@   @   @   @   @@@@@@@@@@@@@@@@@@@@@@@@@@@@@@@@@   @   @@@@@@@@@   @   @@
@@                       @       @   @           @                                   @   @   @   @   @   @   @   @               @   @   @   @   @           @   @   @   @               @   @   @   @                               @   @               @   @@
@@@@@@@@@@@@@@@@@@@@@@@@@@@@@@@@@@   @   @@@@@@@@@@@@@@@@@@@@@@@@@@@@@@@@@@@@@@@@@   @   @   @   @   @   @   @   @@@@@@@@@@@@@@@@@   @   @   @   @@@@@@@@@   @   @   @   @@@@@@@@@@@@@@@@@   @   @   @   @@@@@@@@@@@@@@@@@@@@@@@@@   @   @@@@@@@@@@@@@@@@@   @@
@@                                   @                                           @   @   @   @   @   @       @           @           @   @   @           @   @   @   @   @                   @   @   @   @                       @   @                   @   @@
@@   @@@@@@@@@@@@@@@@@@@@@@@@@@@@@@@@@@@@@@@@@@@@@@@@@@@@@@@@@@@@@@@@@@@@@@@@@   @   @   @   @   @   @@@@@@@@@@@@@@@@@   @   @@@@@@@@@   @   @@@@@@@@@   @   @   @   @   @   @@@@@@@@@@@@@@@@@   @   @   @   @@@@@@@@@@@@@@@@@   @   @@@@@@@@@@@@@@@@@   @   @@
@@                           @       @                               @       @   @       @   @   @           @           @   @           @           @   @       @   @   @   @       @           @   @   @           @       @   @                   @   @   @@
@@@@@@@@@@@@@@@@@@@@@@@@@@   @   @   @   @@@@@@@@@@@@@@@@@@@@@@@@@   @   @   @   @@@@@@@@@   @   @@@@@@@@@   @   @@@@@@@@@   @   @@@@@@@@@@@@@@@@@   @   @@@@@@@@@   @   @   @   @   @   @@@@@@@@@   @   @@@@@@@@@   @   @   @   @@@@@@@@@@@@@@@@@   @   @   @@
@@               @       @   @   @   @   @               @       @   @   @   @               @           @   @               @   @               @   @   @           @       @   @   @   @           @           @   @   @   @                   @   @   @   @@
@@   @@@@@@@@@   @   @   @   @   @   @   @   @@@@@@@@@   @   @   @   @   @   @@@@@@@@@@@@@@@@@@@@@@@@@   @   @@@@@@@@@@@@@@@@@   @   @@@@@@@@@   @   @   @   @@@@@@@@@@@@@@@@@   @   @   @   @@@@@@@@@@@@@@@@@   @   @   @   @@@@@@@@@@@@@@@@@   @   @   @   @@
@@           @   @   @   @       @       @   @           @   @   @   @   @   @                       @   @   @                   @   @           @   @   @   @               @   @       @   @                   @   @   @           @           @   @   @   @@
@@@@@@@@@@   @   @   @   @@@@@@@@@@@@@@@@@   @   @@@@@@@@@   @   @   @   @   @   @@@@@@@@@@@@@@@@@   @   @   @   @@@@@@@@@@@@@@@@@   @   @@@@@@@@@   @   @   @   @@@@@@@@@   @   @@@@@@@@@   @   @@@@@@@@@@@@@@@@@   @   @@@@@@@@@   @   @@@@@@@@@   @   @   @@
@@           @       @           @           @   @           @   @   @   @   @                   @   @   @   @   @               @   @           @   @       @           @   @           @   @   @                   @           @   @   @           @   @   @@
@@   @@@@@@@@@@@@@@@@@@@@@@@@@   @   @@@@@@@@@   @   @@@@@@@@@   @   @   @   @@@@@@@@@@@@@@@@@   @   @   @   @   @   @@@@@@@@@   @   @@@@@@@@@   @   @@@@@@@@@@@@@@@@@   @   @@@@@@@@@   @   @   @   @@@@@@@@@@@@@@@@@@@@@@@@@   @   @   @   @@@@@@@@@   @   @@
@@   @                       @   @   @           @   @           @   @   @                       @   @   @       @   @       @   @   @           @   @                   @   @           @   @   @                               @   @   @               @   @@
@@   @   @@@@@@@@@@@@@@@@@   @   @   @   @@@@@@@@@   @   @@@@@@@@@   @   @@@@@@@@@@@@@@@@@@@@@@@@@   @   @@@@@@@@@   @   @   @   @   @   @@@@@@@@@   @   @@@@@@@@@@@@@@@@@   @   @@@@@@@@@   @   @@@@@@@@@@@@@@@@@@@@@@@@@@@@@@@@@   @   @@@@@@@@@@@@@@@@@   @@
@@   @                   @   @       @   @       @   @   @           @                           @   @               @   @   @   @   @   @           @   @                   @               @                                   @   @                       @@
@@   @@@@@@@@@@@@@@@@@   @   @@@@@@@@@   @   @   @   @   @   @@@@@@@@@@@@@@@@@@@@@@@@@@@@@@@@@   @   @@@@@@@@@@@@@@@@@   @   @   @   @   @   @@@@@@@@@   @   @@@@@@@@@@@@@@@@@@@@@@@@@@@@@@@@@@@@@@@@@@@@@@@@@@@@@@@@@@@@@@@@@   @   @@@@@@@@@@@@@@@@@@@@@@@@@@
@@                   @   @               @   @   @   @   @                           @           @   @               @   @       @   @   @               @   @                               @                                   @                           @@
@@@@@@@@@@@@@@@@@@   @   @@@@@@@@@@@@@@@@@   @   @   @   @@@@@@@@@@@@@@@@@@@@@@@@@   @   @@@@@@@@@   @   @@@@@@@@@   @   @@@@@@@@@   @   @@@@@@@@@@@@@@@@@   @   @@@@@@@@@@@@@@@@@@@@@@@@@   @   @@@@@@@@@@@@@@@@@@@@@@@@@@@@@@@@@@@@@@@@@@@@@@@@@@@@@@@@@   @@
@@               @   @                       @   @   @                           @   @   @           @   @       @   @           @   @                       @                           @   @                                   @                       @   @@
@@   @@@@@@@@@   @   @@@@@@@@@@@@@@@@@@@@@@@@@   @   @@@@@@@@@@@@@@@@@@@@@@@@@   @   @   @   @@@@@@@@@   @   @   @   @@@@@@@@@   @   @@@@@@@@@@@@@@@@@@@@@@@@@@@@@@@@@@@@@@@@@@@@@@@@@   @   @@@@@@@@@@@@@@@@@@@@@@@@@@@@@@@@@   @   @@@@@@@@@@@@@@@@@   @   @@
@@   @       @   @   @               @           @   @               @           @   @   @           @   @   @   @   @       @   @   @               @       @                           @   @                               @   @   @               @   @   @@
@@   @   @   @   @   @   @@@@@@@@@   @   @@@@@@@@@   @   @@@@@@@@@   @   @@@@@@@@@   @   @@@@@@@@@   @   @   @   @   @   @   @   @   @   @@@@@@@@@   @   @   @   @@@@@@@@@@@@@@@@@@@@@@@@@   @   @@@@@@@@@@@@@@@@@@@@@@@@@   @   @   @   @@@@@@@@@   @   @   @@
@@   @   @   @       @   @           @   @       @   @           @   @   @       @   @           @   @   @   @   @   @   @   @   @   @   @       @   @   @   @   @                           @   @                       @   @   @   @   @       @   @   @   @@
@@   @   @   @@@@@@@@@   @   @@@@@@@@@   @   @   @   @@@@@@@@@   @   @   @   @   @   @@@@@@@@@   @   @   @   @   @   @   @   @   @   @   @   @   @   @   @   @   @   @@@@@@@@@@@@@@@@@@@@@@@@@   @   @@@@@@@@@@@@@@@@@   @   @   @   @   @   @   @   @   @   @@
@@   @   @               @   @       @   @   @   @               @   @   @   @   @   @           @   @   @   @   @   @   @   @   @   @   @   @   @       @   @   @                   @           @   @                   @   @   @   @   @   @   @   @   @   @@
@@   @   @@@@@@@@@@@@@@@@@   @   @   @   @   @   @@@@@@@@@@@@@@@@@   @   @   @   @   @   @@@@@@@@@   @   @   @   @   @   @   @   @   @   @   @   @@@@@@@@@   @   @@@@@@@@@@@@@@@@@   @   @@@@@@@@@   @   @@@@@@@@@@@@@@@@@   @   @   @   @   @   @   @   @   @@
@@   @   @                   @   @   @   @   @                       @       @   @   @   @           @   @   @   @   @   @   @   @   @   @   @               @                   @   @   @           @   @       @       @   @   @   @   @   @   @   @   @   @@
@@   @   @   @@@@@@@@@@@@@@@@@   @   @   @   @@@@@@@@@@@@@@@@@@@@@@@@@@@@@@@@@   @   @   @   @@@@@@@@@   @   @   @   @   @   @   @   @   @   @@@@@@@@@@@@@@@@@@@@@@@@@@@@@@@@@   @   @   @   @@@@@@@@@   @   @   @   @   @   @   @   @   @   @   @   @   @   @@
@@   @   @           @       @   @       @   @                               @   @   @   @               @   @   @       @       @   @   @                   @               @   @   @   @   @           @   @   @   @   @       @   @   @   @   @       @   @@
@@   @   @@@@@@@@@   @   @   @   @@@@@@@@@   @   @@@@@@@@@@@@@@@@@@@@@@@@@   @   @   @   @@@@@@@@@@@@@@@@@   @   @@@@@@@@@@@@@@@@@   @   @@@@@@@@@@@@@@@@@   @   @@@@@@@@@   @   @   @   @   @   @@@@@@@@@   @   @   @   @@@@@@@@@   @   @   @   @@@@@@@@@   @@
@@   @           @   @   @   @   @       @   @                           @   @       @                       @   @                   @                   @   @   @           @   @   @       @   @           @       @           @   @       @               @@
@@   @@@@@@@@@   @   @   @   @   @   @   @   @@@@@@@@@@@@@@@@@@@@@@@@@   @   @@@@@@@@@@@@@@@@@@@@@@@@@@@@@@@@@   @   @@@@@@@@@@@@@@@@@@@@@@@@@@@@@@@@@   @   @   @   @@@@@@@@@   @   @@@@@@@@@   @   @@@@@@@@@@@@@@@@@@@@@@@@@   @   @@@@@@@@@@@@@@@@@@@@@@@@@@
@@               @   @   @   @   @   @   @           @                   @   @               @       @           @   @                               @   @   @   @           @   @           @   @   @                           @   @                       @@
@@@@@@@@@@@@@@@@@@   @   @   @   @   @   @@@@@@@@@   @   @@@@@@@@@@@@@@@@@   @   @@@@@@@@@   @   @   @   @@@@@@@@@   @   @@@@@@@@@@@@@@@@@@@@@@@@@   @   @   @   @@@@@@@@@   @   @@@@@@@@@   @   @   @   @@@@@@@@@@@@@@@@@@@@@@@@@   @   @@@@@@@@@@@@@@@@@   @@
@@                   @   @   @   @   @   @       @   @   @                   @           @   @   @   @   @           @   @                       @   @   @   @           @   @   @       @   @   @   @   @                           @   @       @       @   @@
@@   @@@@@@@@@@@@@@@@@   @   @   @   @   @   @   @   @   @   @@@@@@@@@@@@@@@@@@@@@@@@@   @   @   @   @   @   @@@@@@@@@   @   @@@@@@@@@@@@@@@@@   @   @   @   @@@@@@@@@   @   @   @   @   @   @   @   @   @   @@@@@@@@@@@@@@@@@@@@@@@@@   @   @   @   @   @   @@
@@   @                   @       @   @   @   @   @       @   @                           @   @   @   @   @   @       @   @   @                   @       @   @       @   @   @   @   @   @       @   @   @   @                           @   @   @   @   @   @@
@@   @   @@@@@@@@@@@@@@@@@@@@@@@@@   @   @   @   @@@@@@@@@   @   @@@@@@@@@@@@@@@@@@@@@@@@@   @   @   @   @   @   @   @   @   @   @@@@@@@@@@@@@@@@@@@@@@@@@   @   @   @   @   @   @   @   @@@@@@@@@   @   @   @   @@@@@@@@@@@@@@@@@@@@@@@@@   @   @   @   @   @@
@@   @   @                           @   @   @               @   @                       @   @   @   @   @   @   @   @   @   @                           @   @   @   @   @   @       @           @   @       @   @                       @   @       @   @   @@
@@   @   @   @@@@@@@@@@@@@@@@@@@@@@@@@   @   @@@@@@@@@@@@@@@@@   @   @@@@@@@@@@@@@@@@@   @   @   @   @   @   @   @   @   @   @@@@@@@@@@@@@@@@@@@@@@@@@   @   @   @   @   @   @@@@@@@@@@@@@@@@@   @   @@@@@@@@@   @   @@@@@@@@@@@@@@@@@   @   @@@@@@@@@   @   @@
@@   @   @   @                           @   @                   @   @                   @   @   @       @   @   @   @   @                           @   @   @   @   @   @                   @   @               @   @               @   @   @           @   @@
@@   @   @   @   @@@@@@@@@@@@@@@@@@@@@@@@@   @   @@@@@@@@@@@@@@@@@   @   @@@@@@@@@@@@@@@@@   @   @@@@@@@@@   @   @   @   @@@@@@@@@@@@@@@@@@@@@@@@@   @   @   @   @   @   @@@@@@@@@@@@@@@@@   @   @@@@@@@@@@@@@@@@@   @   @@@@@@@@@   @   @   @   @@@@@@@@@   @@
@@   @       @   @                           @   @               @   @                       @               @   @   @                           @   @   @   @   @   @                   @   @                       @           @   @   @   @   @           @@
@@   @@@@@@@@@   @   @@@@@@@@@@@@@@@@@@@@@@@@@   @   @@@@@@@@@   @   @@@@@@@@@@@@@@@@@@@@@@@@@@@@@@@@@@@@@@@@@   @   @@@@@@@@@@@@@@@@@@@@@@@@@   @   @   @   @   @   @@@@@@@@@@@@@@@@@   @   @@@@@@@@@@@@@@@@@@@@@@@@@@@@@@@@@   @   @   @   @   @   @@@@@@@@@@
@@           @   @   @                           @   @           @   @                                       @   @                   @           @   @   @   @   @   @       @       @   @                   @               @   @   @   @   @   @           @@
@@@@@@@@@@   @   @   @   @@@@@@@@@@@@@@@@@@@@@@@@@   @   @@@@@@@@@   @   @@@@@@@@@@@@@@@@@@@@@@@@@@@@@@@@@   @   @@@@@@@@@@@@@@@@@   @   @@@@@@@@@   @   @   @   @   @   @   @   @   @   @@@@@@@@@@@@@@@@@   @   @@@@@@@@@   @   @   @   @   @   @@@@@@@@@   @@
@@           @   @   @   @                       @   @               @           @                           @                   @   @   @       @   @       @   @   @   @   @   @   @           @       @   @           @   @   @   @   @   @   @           @@
@@   @@@@@@@@@   @   @   @   @@@@@@@@@@@@@@@@@   @   @@@@@@@@@@@@@@@@@@@@@@@@@   @   @@@@@@@@@@@@@@@@@@@@@@@@@@@@@@@@@@@@@@@@@   @   @   @   @   @   @@@@@@@@@   @   @   @   @   @   @@@@@@@@@   @   @   @   @@@@@@@@@   @   @   @   @   @   @   @   @@@@@@@@@@
@@   @       @   @   @   @           @           @   @               @           @   @                               @       @   @       @   @   @   @           @       @       @   @       @   @   @   @           @   @       @   @   @   @   @           @@
@@   @   @   @       @           @   @               @   @           @           @   @                           @   @   @   @           @   @       @                   @           @   @   @       @           @   @           @   @       @           @   @@
@@   @   @   @@@@@@@@@@@@@@@@@   @   @@@@@@@@@@@@@@@@@   @   @@@@@@@@@@@@@@@@@   @   @@@@@@@@@@@@@@@@@@@@@@@@@   @   @   @   @@@@@@@@@   @   @@@@@@@@@@@@@@@@@@@@@@@@@   @   @@@@@@@@@   @   @@@@@@@@@@@@@@@@@   @   @@@@@@@@@   @   @@@@@@@@@@@@@@@@@   @   @@
@@       @                       @                       @                       @                               @       @               @                               @               @                       @               @                       @   @@
@@@@@@@@@@@@@@@@@@@@@@@@@@@@@@@@@@@@@@@@@@@@@@@@@@@@@@@@@@@@@@@@@@@@@@@@@@@@@@@@@@@@@@@@@@@@@@@@@@@@@@@@@@@@@@@@@@@@@@@@@@@@@@@@@@@@@@@@@@@@@@@@@@@@@@@@@@@@@@@@@@@@@@@@@@@@@@@@@@@@@@@@@@@@@@@@@@@@@@@@@@@@@@@@@@@@@@@@@@@@@@@@@@@@@@@@@@@@@@@@@@@@@@@@@@@P@@@
@@@@@@@@@@@@@@@@@@@@@@@@@@@@@@@@@@@@@@@@@@@@@@@@@@@@@@@@@@@@@@@@@@@@@@@@@@@@@@@@@@@@@@@@@@@@@@@@@@@@@@@@@@@@@@@@@@@@@@@@@@@@@@@@@@@@@@@@@@@@@@@@@@@@@@@@@@@@@@@@@@@@@@@@@@@@@@@@@@@@@@@@@@@@@@@@@@@@@@@@@@@@@@@@@@@@@@@@@@@@@@@@@@@@@@@@@@@@@@@@@@@@@@@@@@@@@@@