@@@@@@@@@@@@@@@@@@@@@@@@@@@@@@@@@@@@@@@@@@@@@@@@@@@@@@@@@@@@@
@@@@@@@@@@@@@@@@@@@@@@@@@@@@@F@@@@@@@@@@@@@@@@@@@@@@@@@@@@@@@
@@                  @@@   @@@      @@@         @@@         @@
@@                  @@@   @@@      @@@         @@@         @@
@@                  @@@   @@@      @@@         @@@         @@
@@   @@@@@@@@@      @@@   @@@@@@   @@@@@@@@@   @@@   @@@   @@
@@   @@@            @@@      @@@               @@@   @@@   @@
@@   @@@            @@@      @@@               @@@   @@@   @@
@@   @@@            @@@      @@@               @@@   @@@   @@
@@   @@@@@@@@@@@@@@@@@@@@@   @@@@@@@@@@@@@@@   @@@@@@@@@   @@
@@                           @@@               @@@         @@
@@                           @@@               @@@         @@
@@                           @@@               @@@         @@
@@@@@@@@@@@      @@@   @@@   @@@   @@@@@@@@@@@@@@@   @@@@@@@@
@@   @@@         @@@   @@@   @@@                     @@@   @@
@@   @@@         @@@   @@@   @@@                     @@@   @@
@@   @@@         @@@   @@@   @@@                     @@@   @@
@@   @@@   @@@@@@@@@   @@@@@@@@@@@@@@@@@@@@@@@@@@@   @@@   @@
@@         @@@               @@@               @@@         @@
@@         @@@               @@@               @@@         @@
@@         @@@               @@@               @@@         @@
@@@@@@@@@@@@@@   @@@@@@@@@   @@@@@@@@@@@@@@@   @@@@@@@@@   @@
@@         @@@         @@@         @@@         @@@   @@@   @@
@@         @@@         @@@         @@@         @@@   @@@   @@
@@         @@@         @@@         @@@         @@@   @@@   @@
@@   @@@   @@@@@@@@@   @@@@@@@@@   @@@   @@@@@@@@@   @@@   @@
@@   @@@               @@@   @@@         @@@               @@
@@   @@@               @@@   @@@         @@@               @@
@@   @@@               @@@   @@@         @@@               @@
@@   @@@@@@@@@@@@@@@@@@@@@   @@@@@@@@@@@@@@@   @@@@@@@@@@@@@@
@@         @@@               @@@         @@@               @@
@@         @@@               @@@         @@@               @@
@@         @@@               @@@         @@@               @@
@@@@@@@@   @@@   @@@@@@@@@@@@@@@@@@@@@   @@@@@@@@@@@@@@@   @@
@@         @@@         @@@         @@@               @@@   @@
@@         @@@         @@@         @@@               @@@   @@
@@         @@@         @@@         @@@               @@@   @@
@@   @@@@@@@@@   @@@@@@@@@   @@@   @@@   @@@   @@@@@@@@@   @@
@@                           @@@         @@@               @@
@@                           @@@         @@@               @@
@@                           @@@         @@@               @@
@@@@@@@@@@@@@@@@@@@@@@@@@@@@@@@@P@@@@@@@@@@@@@@@@@@@@@@@@@@@@
@@@@@@@@@@@@@@@@@@@@@@@@@@@@@@@@@@@@@@@@@@@@@@@@@@@@@@@@@@@@@