@@@@@@@@@@@@@@@@@@@@@@@@@@@@@@@@@@@@@@@@@@@@@@@@@@@@@@@@@@@@@@@@@@@@@@@@@@@@@@@@@@@@@@@@@@@@@@@@@@@@@@@@@@@@@@@@@@@@@@@@@@@@@@@@@@@@@@@@@@@@@@@@@@@@@@@@@@@@@@@@@@@@@@@@@@@@@@@@@@@@@@@@@@@@@@@@@@@@@@@@@@@@@@@@@@@@@@@@@@@@@@@@@@@@@@@@@@@@@@@@@@@@@@@@@@@@@
@@F@@@@@@@@@@@@@@@@@@@@@@@@@@@@@@@@@@@@@@@@@@@@@@@@@@@@@@@@@@@@@@@@@@@@@@@@@@@@@@@@@@@@@@@@@@@@@@@@@@@@@@@@@@@@@@@@@@@@@@@@@@@@@@@@@@@@@@@@@@@@@@@@@@@@@@@@@@@@@@@@@@@@@@@@@@@@@@@@@@@@@@@@@@@@@@@@@@@@@@@@@@@@@@@@@@@@@@@@@@@@@@@@@@@@@@@@@@@@@@@@@@@@@@@@@@
@@ @                               @       @                       @                       @                       @                       @               @               @               @                               @               @               @@
@@ @    @@@@@@@@@@@@@@@@@@@@@@@@   @   @   @   @@@@@@@@@@@@@@@@@   @   @@@@@@@@@@@@@@@@@   @   @@@@@@@@@@@@@@@@@   @   @@@@@@@@@@@@@@@@@   @   @@@@@@@@@   @   @@@@@@@@@   @   @@@@@@@@@   @   @@@@@@@@@@@@@@@@@@@@@@@@@   @   @@@@@@@@@   @   @@@@@@@@@   @@
@@ @           @       @       @   @   @   @                   @   @           @       @   @                   @   @   @               @   @   @           @   @       @   @   @       @   @   @       @               @   @           @   @   @       @   @@
@@ @@@@@@@@@   @   @   @   @   @   @   @   @@@@@@@@@@@@@@@@@   @   @@@@@@@@@   @   @   @   @@@@@@@@@@@@@@@@@   @   @   @   @@@@@@@@@   @   @   @   @@@@@@@@@   @   @   @   @   @   @   @   @   @   @   @   @@@@@@@@@   @   @@@@@@@@@   @   @   @   @   @   @@
@@             @   @   @   @   @       @   @                   @               @   @   @                       @       @   @       @   @   @   @               @   @   @       @   @   @   @   @   @   @           @   @               @       @   @   @   @@
@@@@@@@@@@@@       @   @   @   @@@@@@@@@   @   @@@@@@@@@@@@@@@@@@@@@@@@@@@@@@@@@   @   @@@@@@@@@@@@@@@@@@@@@@@@@@@@@@@@@   @   @   @   @   @   @@@@@@@@@@@@@@@@@   @   @@@@@@@@@   @   @   @   @   @   @@@@@@@@@   @   @@@@@@@@@@@@@@@@@@@@@@@@@   @   @   @@
@@                 @       @           @   @   @                                   @                                   @   @   @   @   @   @                   @   @               @       @   @   @           @   @                               @   @   @@
@@ @@@@@@@@@@@@@@@@@@@@@@@@@@@@@@@@@   @   @   @   @@@@@@@@@@@@@@@@@@@@@@@@@@@@@@@@@@@@@@@@@@@@@@@@@@@@@@@@@@@@@@@@@   @   @   @   @   @   @@@@@@@@@@@@@@@@@   @   @@@@@@@@@@@@@@@@@@@@@@@@@   @   @@@@@@@@@   @   @@@@@@@@@@@@@@@@@@@@@@@@@@@@@@@@@   @   @@
@@                                 @   @       @   @               @                                       @       @   @   @   @       @   @       @           @   @                           @   @       @   @                   @               @   @   @@
@@@@@@@@@@@@@@@@@@@@@@@@@@@@@@@@   @   @@@@@@@@@   @   @@@@@@@@@   @   @@@@@@@@@@@@@@@@@@@@@@@@@@@@@@@@@   @   @   @   @   @   @@@@@@@@@   @   @   @   @@@@@@@@@   @   @@@@@@@@@@@@@@@@@@@@@@@@@   @   @   @   @@@@@@@@@@@@@@@@@   @   @@@@@@@@@   @   @   @@
@@                             @   @               @   @       @   @   @                               @   @   @   @   @   @           @   @   @   @   @           @   @                       @   @   @   @   @               @   @   @           @   @   @@
@@ @@@@@@@@@@@@@@@@@@@@@@@@@   @   @@@@@@@@@@@@@@@@@   @   @   @   @   @   @@@@@@@@@@@@@@@@@@@@@@@@@   @   @   @   @   @   @@@@@@@@@   @   @   @   @   @   @@@@@@@@@   @   @@@@@@@@@@@@@@@@@   @   @   @   @   @   @@@@@@@@@   @   @   @   @@@@@@@@@   @   @@
@@         @               @   @           @           @   @   @   @   @           @       @           @   @   @       @   @           @   @   @       @               @   @                   @   @   @       @   @           @   @   @   @           @   @@
@@@@@@@@   @   @@@@@@@@@   @   @@@@@@@@@   @   @@@@@@@@@   @   @   @   @@@@@@@@@   @   @   @   @@@@@@@@@   @   @@@@@@@@@   @   @@@@@@@@@   @   @@@@@@@@@@@@@@@@@@@@@@@@@   @   @@@@@@@@@@@@@@@@@   @   @@@@@@@@@   @   @@@@@@@@@   @   @   @   @@@@@@@@@   @@
@@         @   @       @   @           @   @               @   @   @   @       @   @   @   @   @           @           @   @               @                               @                       @               @   @           @   @   @   @       @   @@
@@ @@@@@@@@@   @   @   @   @@@@@@@@@   @   @@@@@@@@@@@@@@@@@   @   @   @   @   @   @   @   @   @   @@@@@@@@@@@@@@@@@   @   @@@@@@@@@@@@@@@@@@@@@@@@@@@@@@@@@@@@@@@@@@@@@@@@@@@@@@@@@@@@@@@@@@@@@@@@@@@@@@@@@@@@@@@@@   @   @@@@@@@@@   @   @   @   @   @   @@
@@             @   @   @   @           @   @                   @   @   @   @   @   @   @       @   @               @   @                                                                                   @           @   @           @   @   @   @   @   @@
@@@@@@@@@@@@@@@@   @   @   @   @@@@@@@@@   @   @@@@@@@@@@@@@@@@@   @   @   @   @   @   @@@@@@@@@   @   @@@@@@@@@   @   @@@@@@@@@@@@@@@@@@@@@@@@@@@@@@@@@@@@@@@@@@@@@@@@@@@@@@@@@@@@@@@@@@@@@@@@@@@@@@@@@   @   @@@@@@@@@   @   @@@@@@@@@   @   @   @   @   @@
@@                 @   @   @               @   @               @   @       @   @   @   @           @           @   @                                   @                                               @   @   @           @   @           @   @   @   @   @@
@@ @@@@@@@@@@@@@@@@@   @   @@@@@@@@@@@@@@@@@   @   @@@@@@@@@   @   @@@@@@@@@   @   @   @   @@@@@@@@@@@@@@@@@   @   @@@@@@@@@@@@@@@@@@@@@@@@@@@@@@@@@   @   @@@@@@@@@@@@@@@@@@@@@@@@@@@@@@@@@@@@@@@@@   @   @   @   @@@@@@@@@   @   @@@@@@@@@   @   @   @   @@
@@ @               @   @                       @   @       @   @               @   @   @                       @   @               @                   @   @                               @       @   @   @   @   @       @   @           @   @   @   @   @@
@@ @   @@@@@@@@@   @   @@@@@@@@@@@@@@@@@@@@@@@@@   @   @   @   @@@@@@@@@@@@@@@@@   @   @@@@@@@@@@@@@@@@@@@@@@@@@   @   @@@@@@@@@   @   @@@@@@@@@@@@@@@@@   @   @@@@@@@@@@@@@@@@@@@@@@@@@   @   @   @   @   @   @   @   @   @   @@@@@@@@@   @   @   @   @   @@
@@ @   @           @                           @   @   @   @           @           @                           @   @           @   @   @                   @   @               @       @   @   @   @   @   @   @   @   @   @           @   @   @   @   @   @@
@@ @   @   @@@@@@@@@@@@@@@@@@@@@@@@@@@@@@@@@   @   @   @   @@@@@@@@@   @   @@@@@@@@@@@@@@@@@@@@@@@@@@@@@@@@@   @   @@@@@@@@@   @   @   @   @@@@@@@@@@@@@@@@@   @   @@@@@@@@@   @   @   @   @   @   @   @   @   @   @   @   @@@@@@@@@   @   @   @   @   @   @@
@@ @   @           @       @               @   @   @   @           @   @   @               @               @   @           @   @       @   @               @   @           @   @   @   @   @   @   @   @   @   @   @   @               @       @   @   @   @@
@@ @   @@@@@@@@@   @   @   @   @@@@@@@@@   @   @   @   @@@@@@@@@   @   @   @   @@@@@@@@@   @   @@@@@@@@@   @   @@@@@@@@@   @   @@@@@@@@@   @   @@@@@@@@@   @   @@@@@@@@@   @   @   @   @   @   @   @   @   @   @   @   @@@@@@@@@@@@@@@@@@@@@@@@@   @   @   @@
@@ @           @   @   @   @   @       @   @   @   @           @   @       @   @       @   @   @       @   @           @   @               @   @       @   @           @   @   @   @   @   @   @   @   @   @   @   @                               @   @   @@
@@ @@@@@@@@@   @   @   @   @   @   @   @   @   @   @@@@@@@@@   @   @@@@@@@@@   @   @   @   @   @   @   @   @@@@@@@@@   @   @@@@@@@@@@@@@@@@@   @   @   @   @@@@@@@@@   @   @   @   @   @   @   @   @   @   @   @   @@@@@@@@@@@@@@@@@@@@@@@@@@@@@@@@@   @   @@
@@             @       @   @   @   @   @   @   @   @       @   @           @   @   @   @       @   @   @   @           @                       @   @   @               @   @   @   @   @   @   @       @   @   @           @                       @   @   @@
@@@@@@@@@@@@@@@@@@@@@@@@   @   @   @   @   @   @   @   @   @   @@@@@@@@@   @   @   @   @@@@@@@@@   @   @   @   @@@@@@@@@@@@@@@@@@@@@@@@@@@@@@@@@   @   @@@@@@@@@@@@@@@@@   @   @   @   @   @   @@@@@@@@@   @   @@@@@@@@@   @   @@@@@@@@@@@@@@@@@   @   @   @@
@@                         @   @   @   @   @   @   @   @   @           @   @   @   @               @   @   @                                       @                   @   @       @   @   @               @           @   @   @               @   @   @   @@
@@ @@@@@@@@@@@@@@@@@@@@@@@@@   @   @   @   @   @   @   @   @@@@@@@@@   @   @   @   @@@@@@@@@@@@@@@@@   @   @@@@@@@@@@@@@@@@@@@@@@@@@@@@@@@@@@@@@@@@@@@@@@@@@@@@@@@@@   @   @@@@@@@@@   @   @@@@@@@@@@@@@@@@@@@@@@@@@   @   @   @   @@@@@@@@@   @   @   @   @@
@@         @                   @   @   @   @   @       @           @   @       @   @               @   @                                                   @           @   @           @   @                           @   @   @   @       @   @   @   @   @@
@@@@@@@@   @   @@@@@@@@@@@@@@@@@   @   @   @   @@@@@@@@@@@@@@@@@   @   @@@@@@@@@   @   @@@@@@@@@   @   @@@@@@@@@@@@@@@@@@@@@@@@@@@@@@@@@@@@@@@@@@@@@@@@@   @   @@@@@@@@@   @   @@@@@@@@@   @   @@@@@@@@@@@@@@@@@@@@@@@@@   @   @   @   @   @   @   @   @   @@
@@         @   @                   @   @   @                   @   @               @           @   @                                                   @   @   @           @   @           @   @       @                   @   @   @   @   @   @   @       @@
@@ @@@@@@@@@   @   @@@@@@@@@@@@@@@@@   @   @@@@@@@@@@@@@@@@@   @   @@@@@@@@@@@@@@@@@@@@@@@@@   @   @@@@@@@@@@@@@@@@@@@@@@@@@@@@@@@@@@@@@@@@@@@@@@@@@   @   @   @   @@@@@@@@@   @   @@@@@@@@@   @   @   @   @@@@@@@@@@@@@@@@@   @   @   @   @   @   @@@@@@@@@@
@@ @           @   @       @           @           @           @                   @           @   @               @                       @           @   @   @   @       @   @           @   @   @   @                       @   @   @   @   @           @@
@@ @   @@@@@@@@@   @   @   @   @@@@@@@@@@@@@@@@@   @   @@@@@@@@@@@@@@@@@@@@@@@@@   @   @@@@@@@@@   @   @@@@@@@@@   @   @@@@@@@@@@@@@@@@@   @   @@@@@@@@@   @   @   @   @   @   @@@@@@@@@   @   @   @   @@@@@@@@@@@@@@@@@@@@@@@@@   @   @   @   @@@@@@@@@   @@
@@ @               @   @   @   @               @   @                               @   @       @   @   @       @   @           @       @   @   @           @   @   @   @   @           @   @   @   @                               @   @   @           @   @@
@@ @@@@@@@@@@@@@@@@@   @   @   @   @@@@@@@@@   @   @@@@@@@@@@@@@@@@@@@@@@@@@@@@@@@@@   @   @   @   @   @   @   @   @@@@@@@@@   @   @   @   @   @   @@@@@@@@@   @   @   @   @@@@@@@@@   @   @   @   @@@@@@@@@@@@@@@@@@@@@@@@@@@@@@@@@   @   @@@@@@@@@   @   @@
@@                     @       @   @           @                                   @   @   @   @   @   @   @   @               @   @   @   @   @           @   @   @   @               @   @   @   @                               @   @               @   @@
@@@@@@@@@@@@@@@@@@@@@@@@@@@@@@@@   @   @@@@@@@@@@@@@@@@@@@@@@@@@@@@@@@@@@@@@@@@@   @   @   @   @   @   @   @   @@@@@@@@@@@@@@@@@   @   @   @   @@@@@@@@@   @   @   @   @@@@@@@@@@@@@@@@@   @   @   @   @@@@@@@@@@@@@@@@@@@@@@@@@   @   @@@@@@@@@@@@@@@@@   @@
@@                                 @                                           @   @   @   @   @   @       @           @           @   @   @           @   @   @   @   @                   @   @   @   @                       @   @                   @   @@
@@ @@@@@@@@@@@@@@@@@@@@@@@@@@@@@@@@@@@@@@@@@@@@@@@@@@@@@@@@@@@@@@@@@@@@@@@@@   @   @   @   @   @   @@@@@@@@@@@@@@@@@   @   @@@@@@@@@   @   @@@@@@@@@   @   @   @   @   @   @@@@@@@@@@@@@@@@@   @   @   @   @@@@@@@@@@@@@@@@@   @   @@@@@@@@@@@@@@@@@   @   @@
@@                         @       @                               @       @   @       @   @   @           @           @   @           @           @   @       @   @   @   @       @           @   @   @           @       @   @                   @   @   @@
@@@@@@@@@@@@@@@@@@@@@@@@   @   @   @   @@@@@@@@@@@@@@@@@@@@@@@@@   @   @   @   @@@@@@@@@   @   @@@@@@@@@   @   @@@@@@@@@   @   @@@@@@@@@@@@@@@@@   @   @@@@@@@@@   @   @   @   @   @   @@@@@@@@@   @   @@@@@@@@@   @   @   @   @@@@@@@@@@@@@@@@@   @   @   @@
@@             @       @   @   @   @   @               @       @   @   @   @               @           @   @               @   @               @   @   @           @       @   @   @   @           @           @   @   @   @                   @   @   @   @@
@@ @@@@@@@@@   @   @   @   @   @   @   @   @@@@@@@@@   @   @   @   @   @   @@@@@@@@@@@@@@@@@@@@@@@@@   @   @@@@@@@@@@@@@@@@@   @   @@@@@@@@@   @   @   @   @@@@@@@@@@@@@@@@@   @   @   @   @@@@@@@@@@@@@@@@@   @   @   @   @@@@@@@@@@@@@@@@@   @   @   @   @@
@@         @   @   @   @       @       @   @           @   @   @   @   @   @                       @   @   @                   @   @           @   @   @   @               @   @       @   @                   @   @   @           @           @   @   @   @@
@@@@@@@@   @   @   @   @@@@@@@@@@@@@@@@@   @   @@@@@@@@@   @   @   @   @   @   @@@@@@@@@@@@@@@@@   @   @   @   @@@@@@@@@@@@@@@@@   @   @@@@@@@@@   @   @   @   @@@@@@@@@   @   @@@@@@@@@   @   @@@@@@@@@@@@@@@@@   @   @@@@@@@@@   @   @@@@@@@@@   @   @   @@
@@         @       @           @           @   @           @   @   @   @   @                   @   @   @   @   @               @   @           @   @       @           @   @           @   @   @                   @           @   @   @           @   @   @@
@@ @@@@@@@@@@@@@@@@@@@@@@@@@   @   @@@@@@@@@   @   @@@@@@@@@   @   @   @   @@@@@@@@@@@@@@@@@   @   @   @   @   @   @@@@@@@@@   @   @@@@@@@@@   @   @@@@@@@@@@@@@@@@@   @   @@@@@@@@@   @   @   @   @@@@@@@@@@@@@@@@@@@@@@@@@   @   @   @   @@@@@@@@@   @   @@
@@ @                       @   @   @           @   @           @   @   @                       @   @   @       @   @       @   @   @           @   @                   @   @           @   @   @                               @   @   @               @   @@
@@ @   @@@@@@@@@@@@@@@@@   @   @   @   @@@@@@@@@   @   @@@@@@@@@   @   @@@@@@@@@@@@@@@@@@@@@@@@@   @   @@@@@@@@@   @   @   @   @   @   @@@@@@@@@   @   @@@@@@@@@@@@@@@@@   @   @@@@@@@@@   @   @@@@@@@@@@@@@@@@@@@@@@@@@@@@@@@@@   @   @@@@@@@@@@@@@@@@@   @@
@@ @                   @   @       @   @       @   @   @           @                           @   @               @   @   @   @   @   @           @   @                   @               @                                   @   @                       @@
@@ @@@@@@@@@@@@@@@@@   @   @@@@@@@@@   @   @   @   @   @   @@@@@@@@@@@@@@@@@@@@@@@@@@@@@@@@@   @   @@@@@@@@@@@@@@@@@   @   @   @   @   @   @@@@@@@@@   @   @@@@@@@@@@@@@@@@@@@@@@@@@@@@@@@@@@@@@@@@@@@@@@@@@@@@@@@@@@@@@@@@@   @   @@@@@@@@@@@@@@@@@@@@@@@@@@
@@                 @   @               @   @   @   @   @                           @           @   @               @   @       @   @   @               @   @                               @                                   @                           @@
@@@@@@@@@@@@@@@@   @   @@@@@@@@@@@@@@@@@   @   @   @   @@@@@@@@@@@@@@@@@@@@@@@@@   @   @@@@@@@@@   @   @@@@@@@@@   @   @@@@@@@@@   @   @@@@@@@@@@@@@@@@@   @   @@@@@@@@@@@@@@@@@@@@@@@@@   @   @@@@@@@@@@@@@@@@@@@@@@@@@@@@@@@@@@@@@@@@@@@@@@@@@@@@@@@@@   @@
@@             @   @                       @   @   @                           @   @   @           @   @       @   @           @   @                       @                           @   @                                   @                       @   @@
@@ @@@@@@@@@   @   @@@@@@@@@@@@@@@@@@@@@@@@@   @   @@@@@@@@@@@@@@@@@@@@@@@@@   @   @   @   @@@@@@@@@   @   @   @   @@@@@@@@@   @   @@@@@@@@@@@@@@@@@@@@@@@@@@@@@@@@@@@@@@@@@@@@@@@@@   @   @@@@@@@@@@@@@@@@@@@@@@@@@@@@@@@@@   @   @@@@@@@@@@@@@@@@@   @   @@
@@ @       @   @   @               @           @   @               @           @   @   @           @   @   @   @   @       @   @   @               @       @                           @   @                               @   @   @               @   @   @@
@@ @   @   @   @   @   @@@@@@@@@   @   @@@@@@@@@   @   @@@@@@@@@   @   @@@@@@@@@   @   @@@@@@@@@   @   @   @   @   @   @   @   @   @   @@@@@@@@@   @   @   @   @@@@@@@@@@@@@@@@@@@@@@@@@   @   @@@@@@@@@@@@@@@@@@@@@@@@@   @   @   @   @@@@@@@@@   @   @   @@
@@ @   @   @       @   @           @   @       @   @           @   @   @       @   @           @   @   @   @   @   @   @   @   @   @   @       @   @   @   @   @                           @   @                       @   @   @   @   @       @   @   @   @@
@@ @   @   @@@@@@@@@   @   @@@@@@@@@   @   @   @   @@@@@@@@@   @   @   @   @   @   @@@@@@@@@   @   @   @   @   @   @   @   @   @   @   @   @   @   @   @   @   @   @@@@@@@@@@@@@@@@@@@@@@@@@   @   @@@@@@@@@@@@@@@@@   @   @   @   @   @   @   @   @   @   @@
@@ @   @               @   @       @   @   @   @               @   @   @   @   @   @           @   @   @   @   @   @   @   @   @   @   @   @   @       @   @   @                   @           @   @                   @   @   @   @   @   @   @   @   @   @@
@@ @   @@@@@@@@@@@@@@@@@   @   @   @   @   @   @@@@@@@@@@@@@@@@@   @   @   @   @   @   @@@@@@@@@   @   @   @   @   @   @   @   @   @   @   @   @@@@@@@@@   @   @@@@@@@@@@@@@@@@@   @   @@@@@@@@@   @   @@@@@@@@@@@@@@@@@   @   @   @   @   @   @   @   @   @@
@@ @   @                   @   @   @   @   @                       @       @   @   @   @           @   @   @   @   @   @   @   @   @   @   @               @                   @   @   @           @   @       @       @   @   @   @   @   @   @   @   @   @@
@@ @   @   @@@@@@@@@@@@@@@@@   @   @   @   @@@@@@@@@@@@@@@@@@@@@@@@@@@@@@@@@   @   @   @   @@@@@@@@@   @   @   @   @   @   @   @   @   @   @@@@@@@@@@@@@@@@@@@@@@@@@@@@@@@@@   @   @   @   @@@@@@@@@   @   @   @   @   @   @   @   @   @   @   @   @   @   @@
@@ @   @           @       @   @       @   @                               @   @   @   @               @   @   @       @       @   @   @                   @               @   @   @   @   @           @   @   @   @   @       @   @   @   @   @       @   @@
@@ @   @@@@@@@@@   @   @   @   @@@@@@@@@   @   @@@@@@@@@@@@@@@@@@@@@@@@@   @   @   @   @@@@@@@@@@@@@@@@@   @   @@@@@@@@@@@@@@@@@   @   @@@@@@@@@@@@@@@@@   @   @@@@@@@@@   @   @   @   @   @   @@@@@@@@@   @   @   @   @@@@@@@@@   @   @   @   @@@@@@@@@   @@
@@ @           @   @   @   @   @       @   @                           @   @       @                       @   @                   @                   @   @   @           @   @   @       @   @           @       @           @   @       @               @@
@@ @@@@@@@@@   @   @   @   @   @   @   @   @@@@@@@@@@@@@@@@@@@@@@@@@   @   @@@@@@@@@@@@@@@@@@@@@@@@@@@@@@@@@   @   @@@@@@@@@@@@@@@@@@@@@@@@@@@@@@@@@   @   @   @   @@@@@@@@@   @   @@@@@@@@@   @   @@@@@@@@@@@@@@@@@@@@@@@@@   @   @@@@@@@@@@@@@@@@@@@@@@@@@@
@@             @   @   @   @   @   @   @           @                   @   @               @       @           @   @                               @   @   @   @           @   @           @   @   @                           @   @                       @@
@@@@@@@@@@@@@@@@   @   @   @   @   @   @@@@@@@@@   @   @@@@@@@@@@@@@@@@@   @   @@@@@@@@@   @   @   @   @@@@@@@@@   @   @@@@@@@@@@@@@@@@@@@@@@@@@   @   @   @   @@@@@@@@@   @   @@@@@@@@@   @   @   @   @@@@@@@@@@@@@@@@@@@@@@@@@   @   @@@@@@@@@@@@@@@@@   @@
@@                 @   @   @   @   @   @       @   @   @                   @           @   @   @   @   @           @   @                       @   @   @   @           @   @   @       @   @   @   @   @                           @   @       @       @   @@
@@ @@@@@@@@@@@@@@@@@   @   @   @   @   @   @   @   @   @   @@@@@@@@@@@@@@@@@@@@@@@@@   @   @   @   @   @   @@@@@@@@@   @   @@@@@@@@@@@@@@@@@   @   @   @   @@@@@@@@@   @   @   @   @   @   @   @   @   @   @@@@@@@@@@@@@@@@@@@@@@@@@   @   @   @   @   @   @@
@@ @                   @       @   @   @   @   @       @   @                           @   @   @   @   @   @       @   @   @                   @       @   @       @   @   @   @   @   @       @   @   @   @                           @   @   @   @   @   @@
@@ @   @@@@@@@@@@@@@@@@@@@@@@@@@   @   @   @   @@@@@@@@@   @   @@@@@@@@@@@@@@@@@@@@@@@@@   @   @   @   @   @   @   @   @   @   @@@@@@@@@@@@@@@@@@@@@@@@@   @   @   @   @   @   @   @   @@@@@@@@@   @   @   @   @@@@@@@@@@@@@@@@@@@@@@@@@   @   @   @   @   @@
@@ @   @                           @   @   @               @   @                       @   @   @   @   @   @   @   @   @   @                           @   @   @   @   @   @       @           @   @       @   @                       @   @       @   @   @@
@@ @   @   @@@@@@@@@@@@@@@@@@@@@@@@@   @   @@@@@@@@@@@@@@@@@   @   @@@@@@@@@@@@@@@@@   @   @   @   @   @   @   @   @   @   @@@@@@@@@@@@@@@@@@@@@@@@@   @   @   @   @   @   @@@@@@@@@@@@@@@@@   @   @@@@@@@@@   @   @@@@@@@@@@@@@@@@@   @   @@@@@@@@@   @   @@
@@ @   @   @                           @   @                   @   @                   @   @   @       @   @   @   @   @                           @   @   @   @   @   @                   @   @               @   @               @   @   @           @   @@
@@ @   @   @   @@@@@@@@@@@@@@@@@@@@@@@@@   @   @@@@@@@@@@@@@@@@@   @   @@@@@@@@@@@@@@@@@   @   @@@@@@@@@   @   @   @   @@@@@@@@@@@@@@@@@@@@@@@@@   @   @   @   @   @   @@@@@@@@@@@@@@@@@   @   @@@@@@@@@@@@@@@@@   @   @@@@@@@@@   @   @   @   @@@@@@@@@   @@
@@ @       @   @                           @   @               @   @                       @               @   @   @                           @   @   @   @   @   @                   @   @                       @           @   @   @   @   @           @@
@@ @@@@@@@@@   @   @@@@@@@@@@@@@@@@@@@@@@@@@   @   @@@@@@@@@   @   @@@@@@@@@@@@@@@@@@@@@@@@@@@@@@@@@@@@@@@@@   @   @@@@@@@@@@@@@@@@@@@@@@@@@   @   @   @   @   @   @@@@@@@@@@@@@@@@@   @   @@@@@@@@@@@@@@@@@@@@@@@@@@@@@@@@@   @   @   @   @   @   @@@@@@@@@@
@@         @   @   @                           @   @           @   @                                       @   @                   @           @   @   @   @   @   @       @       @   @                   @               @   @   @   @   @   @           @@
@@@@@@@@   @   @   @   @@@@@@@@@@@@@@@@@@@@@@@@@   @   @@@@@@@@@   @   @@@@@@@@@@@@@@@@@@@@@@@@@@@@@@@@@   @   @@@@@@@@@@@@@@@@@   @   @@@@@@@@@   @   @   @   @   @   @   @   @   @   @@@@@@@@@@@@@@@@@   @   @@@@@@@@@   @   @   @   @   @   @@@@@@@@@   @@
@@         @   @   @   @                       @   @               @           @                           @                   @   @   @       @   @       @   @   @   @   @   @   @           @       @   @           @   @   @   @   @   @   @           @@
@@ @@@@@@@@@   @   @   @   @@@@@@@@@@@@@@@@@   @   @@@@@@@@@@@@@@@@@@@@@@@@@   @   @@@@@@@@@@@@@@@@@@@@@@@@@@@@@@@@@@@@@@@@@   @   @   @   @   @   @@@@@@@@@   @   @   @   @   @   @@@@@@@@@   @   @   @   @@@@@@@@@   @   @   @   @   @   @   @   @@@@@@@@@@
@@ @       @   @   @   @           @           @   @               @           @   @                               @       @   @       @   @   @   @           @       @       @   @       @   @   @   @           @   @       @   @   @   @   @           @@
@@ @   @   @       @           @   @               @   @           @           @   @                           @   @   @   @           @   @       @                   @           @   @   @       @           @   @           @   @       @           @   @@
@@ @   @   @@@@@@@@@@@@@@@@@   @   @@@@@@@@@@@@@@@@@   @   @@@@@@@@@@@@@@@@@   @   @@@@@@@@@@@@@@@@@@@@@@@@@   @   @   @   @@@@@@@@@   @   @@@@@@@@@@@@@@@@@@@@@@@@@   @   @@@@@@@@@   @   @@@@@@@@@@@@@@@@@   @   @@@@@@@@@   @   @@@@@@@@@@@@@@@@@   @   @@
@@     @                       @                       @                       @                               @       @               @                               @               @                       @               @                       @   @@
@@@@@@@@@@@@@@@@@@@@@@@@@@@@@@@@@@@@@@@@@@@@@@@@@@@@@@@@@@@@@@@@@@@@@@@@@@@@@@@@@@@@@@@@@@@@@@@@@@@@@@@@@@@@@@@@@@@@@@@@@@@@@@@@@@@@@@@@@@@@@@@@@@@@@@@@@@@@@@@@@@@@@@@@@@@@@@@@@@@@@@@@@@@@@@@@@@@@@@@@@@@@@@@@@@@@@@@@@@@@@@@@@@@@@@@@@@@@@@@@@@@@@@@@@P@@@
@@@@@@@@@@@@@@@@@@@@@@@@@@@@@@@@@@@@@@@@@@@@@@@@@@@@@@@@@@@@@@@@@@@@@@@@@@@@@@@@@@@@@@@@@@@@@@@@@@@@@@@@@@@@@@@@@@@@@@@@@@@@@@@@@@@@@@@@@@@@@@@@@@@@@@@@@@@@@@@@@@@@@@@@@@@@@@@@@@@@@@@@@@@@@@@@@@@@@@@@@@@@@@@@@@@@@@@@@@@@@@@@@@@@@@@@@@@@@@@@@@@@@@@@@@@@@