@@@@@@@@@@@@@@@@@@@@@@@@@
@@@@@@@@@@@F@@@@@@@@@@@@@
@@                     @@
@@                     @@
@@                     @@
@@                     @@
@@                     @@
@@                     @@
@@                     @@
@@                     @@
@@                     @@
@@                     @@
@@                     @@
@@                     @@
@@                     @@
@@                     @@
@@                     @@
@@                     @@
@@                     @@
@@                     @@
@@                     @@
@@                     @@
@@        P            @@
@@@@@@@@@@@@@@@@@@@@@@@@@
@@@@@@@@@@@@@@@@@@@@@@@@@